Breakable Block Test
Singleplayer
22
16
12111211121112111211121112111211121112111211
11000000000000000000000000000000000000000012
12000000000000000000000000000000000000000011
11000000000000000000000000000000000000000012
12111212110000000000000000000000000000000011
11121111120000000000000000000000000000000012
12000000000000000000000000000000000000000011
11000000000000000000000000000000000000000012
12000000000000000202010201000000000000000011
11000000000000000200020000000000200000000012
12000000000000000000000000000000000000000011
11000000000000000000000000000000200000000012
12000000000000000000000000000000110000000011
110000sp000000000000000000000000200000000012
12000000000000000000000000000000000000000011
11121112111211121112111211121112111211121112