Larry Level
Singleplayer
12121212121212121212121212121212121212121212
12000000000000000000000000000000000000000012
12000000000000000000000000000000000000000012
12121212121212120000000000000000000000000012
12121212121212120000000012121212121212121212
12000000000000000000000012121212121212121212
12000000000000000000000000000000000000000012
12121212121212120000000000000000000000000012
12121212121212120000000012121212121212121212
12000000000000000000000012121212121212121212
12000000000000000000000000000000000000000012
12000000000000000000000000000000000000000012
12000000000000000000000000000000000000000012
1200sp00000000000000000000000000000000000012
12000000000000000000000000000000000000000012
12121212121212121212121212121212121212121212
