Level 003
Singleplayer
22
16
12111211121112111211121112111211121112111211
11000000000000000000000000000000000000000012
120000000000e1000000000000000000000000000011
11000000101220202020202010000000000000000012
12000000000000000000000010000000000000000011
11000000000000000000000010000000000000000012
12000000000000000000000010000000000000000011
11000000000000000000000010000000000000000012
120000sp0000000000001010100000000000e0000011
11000000000000000000100000000000000000000012
12000000000000000000100000000000000000000011
11000000000000000000100000000000000000000012
12000000000000000000102020202020121000000011
1100000000000000000000000000000000e100000012
12000000000000000000000000000000000000000011
11121112111211121112111211121112111211121112
