Level 025
Singleplayer
22
16
12111211121112111211121112111211121112111211
11000000000000000000000000000000000000000012
12000000000000000000000000000000000000000011
11000000000012122012201220122012201200000012
12000000000012000000000000000000001200000011
11000000000012000000000000000000000000000012
12000000000012000000000000000000000000000011
110000sp000012000000000000000000000000000012
12000000000012000000000000000000000000000011
11000000000012000000000000000000000000000012
12000000000012000000000000000000000000000011
11000000000012000000000000000000001200000012
12000000000012122012201220122012201200000011
11000000000000000000000000000000000000000012
12000000000000000000000000000000000000000011
11121112111211121112111211121112111211121112