Level 002
Singleplayer
22
16
12111211121112111211121112111211121112111211
11000000000000000000000000000000000000000012
12000000000000000000000000000000000000000011
11000000000000000000000000000000000000e00012
12000000000000000000000000000000000000000011
11000000101011111111121212111111000000000012
12000000000000000000000000000000000000000011
11000000000000000000000000000000000000000012
12000000000000000000000000000000000000000011
11000000000000001010111111121212111111000012
12000000000000000000000000000000000000000011
11000000000000000000000000000000000000000012
12000000000000000000000000000000000000000011
1100sp00000000000000000000000000000000000012
12000000000000000000000000000000000000000011
11121112111211121112111211121112111211121112