Level 090
Singleplayer
22
16
12111211121112111211121112111211121112111211
11000000000000000000000000000000000000000012
12000000000000000000000000000000000000000011
11000000000000000000000000000000000000000012
12000000000000000000000000000000000000000011
11000000000000000000000000000000000000000012
12000000000000000000000000000000000000000011
11000000000000000000000000000000000000000012
12000000000000000000000000000000000000000011
11000000000000000000000000000000000000000012
12000000000000000000000000000000000000000011
11000000000000000000000000000000000000000012
12000000000000000000000000000000000000000011
11000000000000000000000000000000000000000012
12000000000000000000000000000000000000000011
11121112111211121112111211121112111211121112