Level 008
Singleplayer
22
16
12111211121112111211121112111211121112111211
11000000000000000000000000000000000000000012
1200000000000000000000000000000000000000e411
11000000200000002020111120200000002000000012
1200000020000000000000000000e300002000000011
11000000202000000000000000000000202000000012
12000000002000000000000000000000200000000011
11000000001100000000000000000000110000000012
1200sp00001100000000000000000000110000e30011
11000000001100000000000000000000110000000012
12000000002000000000000000000000202000000011
1100000020200000000000000000e300020000000012
12000000200000002020111120200000020000000011
11000000000000000000000000000000000000e40012
12000000000000000000000000000000000000000011
11121112111211121112111211121112111211121112
