Level 062
Singleplayer
22
16
12111211121112111211121112111211121112111211
11000000000000000000000000000000000000000012
120000e400000000000000e700000000000000000011
11000000110000000000000000000000001100000012
12000000110000000000000000000000001100000011
11000000111111111111-1-1-1111111111100000012
12000000110000000000000000000000001100000011
11000000-1000000000000000000000000-100000012
12000000-10000e600000000e500000000-100000011
11000000110000000000000000000000001100000012
120000001111111111-1-1-111111111111100000011
110000001100000000000000e3000000001100e40012
1200sp00110000000000000000000000001100000011
11000000000000000000000000000000000000000012
12000000000000000000000000000000000000000011
11121112111211121112111211121112111211121112