Breakable Block Test
Singleplayer
22
16
12111211121112111211121112111211121112111211
11000000000000000000000000000000000000000012
12000000000000000000000000000000000000000011
11000000001100000000000000110000000000000012
12000000001100000000000000200000000000000011
1100sp000000000000000000002000000000e0000012
12000000001100000000000000200000000000000011
11000000001100000000000000110000000000000012
12000000000000000000000000000000000000000011
11000000000000000000000000000000000000000012
12111211121112111211121112111211121112111211
11000000000000000000000000000000000000000012
12111111111111111111111111111111111111111111
11111111111111111111111111111111111111111112
12111211121112111211121112111211121112111211
11121112111211121112111211121112111211121112